Property	Value
s72	l0
65001	Property	Property
ProductCode	{88C1C6AC-10A8-4ACF-9C3D-DA61766EA8DA}
ProductLanguage	1041
Manufacturer	%MANUFACTURER%
ProductVersion	%VERSION%
ProductName	%PRODUCT_NAME%
UpgradeCode	%UPGRADE_CODE%
ARPHELPLINK	%HELP_LINK%
AppsShutdownOption	All
BannerBitmap	bannrbmp
ButtonText_Back	< 戻る(&B)
ButtonText_Browse	参照(&o)
ButtonText_Cancel	キャンセル
ButtonText_Exit	終了(&E)
ButtonText_Finish	終了(&F)
ButtonText_Ignore	無視(&I)
ButtonText_Install	インストール(&I)
ButtonText_Next	次(&N) >
ButtonText_No	いいえ(&N)
ButtonText_OK	OK
ButtonText_Print	印刷(&P)
ButtonText_Remove	削除(&R)
ButtonText_Repair	修復(&R)
ButtonText_Reset	リセット(&R)
ButtonText_Resume	中断(&R)
ButtonText_Retry	再試行(&R)
ButtonText_Return	戻る(&R)
ButtonText_Yes	はい(&Y)
CompleteSetupIcon	completi
ComponentDownload	ftp://anonymous@microsoft.com/components/
CustomSetupIcon	custicon
DefaultUIFont	DlgFont8
DialogBitmap	dlgbmp
DlgTitleFont	{&DlgFontBold8}
ErrorDialog	ErrorDlg
ExclamationIcon	exclamic
IAgree	No
INSTALLLEVEL	3
InfoIcon	info
InstallMode	Typical
InstallerIcon	insticon
Link	Windows Installer Development Tools on MSDN
LinkURL	http://msdn2.microsoft.com/en-us/library/aa372834(VS.85).aspx
PIDTemplate	12345<###-%%%%%%%>@@@@@
PROMPTROLLBACKCOST	P
ProductID	none
Progress1	インストール中
Progress2	インストール
RemoveIcon	removico
RepairIcon	repairic
Setup	セットアップ
Wizard	セットアップウィザード
ShowUserRegistrationDlg	1
WRITEENV	1
ALLUSERS	2
MSIINSTALLPERUSER	1
